11111111111111111111111
10001000000000000010001
10101011111011111010101
10000000100000100000001
11101010101110101010111
10001010101010101010001
10101010101110101010101
10001010000000001010001
11111010111111101011111
10000010000000001000001
10111110111011101111101
10000000100000100000001
10111110111111101111101
10000010000000001000001
11111010111111101011111
10001010000000001010001
10101010101110101010101
10001010101010101010001
11101010101110101010111
10000000100000100000001
10101011111011111010101
10001000000000000010001
11111111111111111111111